7 6 4 0 0 0 0 0 0
0 0 8 0 0 4 0 1 6
1 0 2 8 0 5 0 0 0
3 0 9 0 0 0 6 7 0
0 0 0 2 9 0 0 0 4
0 5 0 7 0 0 1 8 0
0 0 7 0 0 0 0 0 1
9 1 5 0 0 0 0 0 0
0 0 0 9 0 0 0 2 5